---
D D D D D D D D D D 
D 1 1 1 1 1 1 1 1 D 
D 1 1 1 1 1 1 1 1 D 
D 1 1 1 1 1 1 1 1 D 
D 1 1 1 1 I 1 1 1 D 
D 1 1 1 1 1 1 1 1 D 
D 1 1 1 1 1 1 1 1 D 
D 1 1 1 1 1 1 1 1 D 
D 1 1 1 1 1 1 1 1 D 
D D D D D D D D D D 
---
