---
D D D D D D D D D D 
D 1 1 1 1 1 1 1 1 8 
D e e e e e e e e D 
D 1 1 1 1 1 1 1 1 D 
D F D G 1 1 3 D F D 
D G D D D D D D G D 
D 1 1 1 D D 1 1 1 D 
D D D D D D F D D D 
D 1 1 h D D h 1 1 D 
D 8 D D D D D D 8 D 
---
